111111111111111111111111111111111111111
1000000000000000001E1000000000000000001
101111011110111100101C01111011110111101
1000000000C0000000101000000000000000001
101001010010100100101001001010010100101
101111011110111100101001111011110111101
10000000000000P0000C0000000000000000001
100000000000000000101000000000000000001
101111011110111100101001111011110111101
10100101001C100100101001001C10010100101
101001C1001010010010100100101001C100101
101001010010100100101001001010010100101
101111011110111100111001111011110111101
100000000000000000101000000000000000001
101001C1001010010010100100101001C100101
10100101001C100100101001001C10010100101
111111111111111111111111111111111111111
