1111111
1E0C0C1
11P01C1
1111111
