1111111111111
10010111000C1
10E000000C001
1P0011C000001
1111111111111