1111111111111111111111111111111111111111111111
110000000000P00C00000C0C00000C0000000000000001
1111111111111111111111111111111111111111111101
10000000C0000000000000000000000000000000000001
1011111111111111111111111111111111111111111111
100000C00000000000C00000000000000000E000000011
1111111111111111111111111111111111111111111111
