111111111111111111111111111111111111111
100000000000000000000000000000000000001
101111111111111111111111111111111111111
1C00000000000000000000000000000000000E1
111111111111111111111111111111110000001
100000000000000000000000000000000000001
111111111111111111111111111111110000001
100000000000000000000000000000000000001
111111111111111111111111111111110000001
1000000000000000000000000000000000000P1
111111111111111111111111111111111111111
