111111111111111111111111111111111111111
100000000000000000000000000000000000001
1C001111100000000C000000000000000000001
1CCC0C0C11110000000000C0000000000000001
11111111P00000000000000000C000000000001
1CCCCCCC0111000000000000000000000000001
11111111C0000000000000000C0000000000001
1CCCCCCC0000000000000000000000000000001
100000001000000000000000000000000000001
100000001000000000000000000000000000001
10000000000000C000000000000000000C00001
1000C111100000C00000000000C000000000E01
100000000000000000000000000000000000001
100000001000000000000000000000000000001
100000001000000000000000000000000000001
111111111111111111111111111111111111111
