11111111111111111111111111111111111111
11000000000000000000000000000000000001
10111111111111111111111111111111111101
101000000000C0000000000000000000000E01
10100000011111111111111111110000000101
10100000000C00000000000000000000000101
101000000000000111111111111111000C0101
1010000000000000000000000C000000000101
101000001111111111111C1111100000000101
10100000000C00000000000000000000000101
10100111111C11111111111000000000000101
10100000000C00000000000000000000000101
10100000001C11111111111111111100000101
10100000000000000000000000000000000101
10000011111111111111111110000000000101
10000000000011111111111111111111111101
1C0000000000000000000000000000000000P1
11111111111111111111111111111111111111
