111111111111111111111111111111111111111111111111111111111
100000000000000000000000000C0000000C000000000000000000001
101111111111111111111111111111111111111111111111111110101
101010101010101000000000000000000000000000101010101010101
101010101010101000000000000000000000000000101010101010101
101000100010001000000000000000000000000000101000100010101
101010101010101000000000000000000000000000101010101010101
101010101010101000000000E000000000CC0C0000000010101010101
101010101010101000000000000000000000000000101010101010101
101010101010101000000000000000000000000000101010101010101
10101010101010000000000000000000C000000000101010101010101
101010101010101000000000C00000000000000000101010101010101
1010100010001010000000000C0000000000000000100010001000101
1010101010101010000000000000C0000000000000101010101010101
101010101010101000000000000000000000C00000101010101010101
1010111111111111111111111111111111111111111111111111111P1
100000000000000000000000000000000000000000000000000000011
111111111111111111111111111111111111111111111111111111111
