11111111111111111111111111111111111111
1000P010000100000000000000000000000001
10C00010000100100001111111111110010C01
10001000100000100000000000000000010001
10001000100000101110110000000000010001
10011101100C11101010011100111000000001
10000000100010000000000100100011100001
10000010111110111111110111100010000001
10011010000000000C0000001000001C000001
100C1010000110111111101010000011111111
10011010000000000000000000000000000001
10000010000001000001111111100111111001
10000000001000000001000000100100000001
10111111110000100001000000100100000C01
100000C0000100100000000C000001000000E1
10011111111000100000111111000111110001
10000000000000100100100001000000000001
111111000000111110000011110000CCC00101
11111111111111111111111111111111111111
