1111111111111111111111111111111111111
1E00000000000000000000000000000000101
1000000000000000001000000000000000001
1000101010101010101010101010100001011
1000100010001000100010001000100101001
1111111111111111111111111111111111101
1010101010101010101010101010101010101
1000000000000000000000000000000000001
1101010101011101111111011101010101011
100000C0000000000P0000000000C00000001
1010100010101010101010101010101010101
101111C111111111111111111111111111101
10010001000100010C1C01000100010001001
110101C1010101010C1C01010101010101011
10000010010100000C1C00000000000000001
10000010010100000C1C00000000000000001
1111111111111111111111111111111111111
