111111111111111111111111111111111111111
1000000010C0110000000000000001000100011
100000100010000000000000010100010000001
1C0000001000110010C01010110001000100001
100000100010011000100100010100010000001
100000001000110010001001010001000100001
1000C0100010011000100100010100010000001
111111101000110011011110110001000100001
100000001000000100000000100111111111101
10000C0011111111101111101000C00000000C1
100000001010000000101000011110C00000001
1000P0001100111011100011000001001000001
100000001001010100001100110100100010001
1000000010100000011100000010C0001000001
100000C0000010111000000C0001C0100010E01
111111111111111111111111111111111111111
